#.######..############
#.....................
#.....................  
#.######..##.#######.#
#.######..##.#######.#
#.........##.........#
#.#####.##...#######.#
#.#####.##...#######.#
#....................#
#.#########..#######.#
#.#########..#######.#
#....................#
###########..#######.#